5 10
|--------|
|.FP|..-.|
|..-|.@P.|
|.F....-.|
|--------|